cy LSHIFT 15 -> dc
dt LSHIFT 15 -> dx
lv LSHIFT 15 -> lz
ip LSHIFT 15 -> it
bi LSHIFT 15 -> bm
ge LSHIFT 15 -> gi
hu LSHIFT 15 -> hy
jk LSHIFT 15 -> jo
eo LSHIFT 15 -> es
kf LSHIFT 15 -> kj
an LSHIFT 15 -> ar
gz LSHIFT 15 -> hd
fj LSHIFT 15 -> fn
cd LSHIFT 15 -> ch
la LSHIFT 15 -> le
as RSHIFT 5 -> av
et RSHIFT 5 -> ew
dy RSHIFT 1 -> er
iu RSHIFT 1 -> jn
as RSHIFT 1 -> bl
fo RSHIFT 5 -> fr
kk RSHIFT 2 -> kl
ci RSHIFT 2 -> cj
hz RSHIFT 5 -> ic
dv LSHIFT 1 -> ep
he RSHIFT 5 -> hh
iu RSHIFT 2 -> iv
dd RSHIFT 2 -> de
kk RSHIFT 3 -> km
kh LSHIFT 1 -> lb
he RSHIFT 1 -> hx
lf RSHIFT 2 -> lg
lf RSHIFT 5 -> li
fo RSHIFT 1 -> gh
hz RSHIFT 3 -> ib
jp RSHIFT 3 -> jr
jp RSHIFT 2 -> jq
jp RSHIFT 5 -> js
jm LSHIFT 1 -> kg
et RSHIFT 1 -> fm
eq LSHIFT 1 -> fk
ir LSHIFT 1 -> jl
gg LSHIFT 1 -> ha
hz RSHIFT 1 -> is
gj RSHIFT 5 -> gm
gj RSHIFT 2 -> gk
gj RSHIFT 1 -> hc
bn RSHIFT 2 -> bo
kk RSHIFT 5 -> kn
fl LSHIFT 1 -> gf
iu RSHIFT 5 -> ix
et RSHIFT 3 -> ev
hb LSHIFT 1 -> hv
hw LSHIFT 1 -> iq
ci RSHIFT 5 -> cl
dd RSHIFT 5 -> dg
as RSHIFT 2 -> at
he RSHIFT 2 -> hf
da LSHIFT 1 -> du
jp RSHIFT 1 -> ki
et RSHIFT 2 -> eu
fo RSHIFT 2 -> fp
fo RSHIFT 3 -> fq
lf RSHIFT 1 -> ly
gj RSHIFT 3 -> gl
dd RSHIFT 1 -> dw
dy RSHIFT 5 -> eb
he RSHIFT 3 -> hg
bn RSHIFT 1 -> cg
cf LSHIFT 1 -> cz
ci RSHIFT 1 -> db
ci RSHIFT 3 -> ck
iu RSHIFT 3 -> iw
lf RSHIFT 3 -> lh
dd RSHIFT 3 -> df
bn RSHIFT 3 -> bp
dy RSHIFT 2 -> dz
dy RSHIFT 3 -> ea
kk RSHIFT 1 -> ld
bn RSHIFT 5 -> bq
bk LSHIFT 1 -> ce
ap LSHIFT 1 -> bj
hz RSHIFT 2 -> ia
lc LSHIFT 1 -> lw
as RSHIFT 3 -> au
x RSHIFT 1 -> aq
s LSHIFT 15 -> w
x RSHIFT 5 -> aa
u LSHIFT 1 -> ao
iu AND jf -> jh
ia AND ig -> ii
kl AND kr -> kt
eu AND fa -> fc
kk AND kv -> kx
at AND az -> bb
gn AND gp -> gq
iy AND ja -> jb
gr AND gt -> gu
ko AND kq -> kr
gk AND gq -> gs
lg AND lm -> lo
et AND fe -> fg
df AND dg -> di
kw AND ky -> kz
hg AND hh -> hj
ks AND ku -> kv
dl AND dn -> do
cj AND cp -> cr
ln AND lp -> lq
b RSHIFT 1 -> v
be AND bg -> bh
ga AND gc -> gd
bp AND bq -> bs
id AND if -> ig
he AND hp -> hr
b RSHIFT 5 -> f
ck AND cl -> cn
dp AND dr -> ds
km AND kn -> kp
dh AND dj -> dk
cm AND co -> cp
jc AND je -> jf
fp AND fv -> fx
ba AND bc -> bd
ev AND ew -> ey
iw AND ix -> iz
ab AND ad -> ae
fs AND fu -> fv
jx AND jz -> ka
af AND ah -> ai
lr AND lt -> lu
iv AND jb -> jd
bn AND by -> ca
ih AND ij -> ik
c LSHIFT 1 -> t
ea AND eb -> ed
jt AND jv -> jw
ex AND ez -> fa
de AND dk -> dm
fo AND fz -> gb
ci AND ct -> cv
jg AND ji -> jj
dy AND ej -> el
cu AND cw -> cx
gl AND gm -> go
aj AND al -> am
b RSHIFT 3 -> e
au AND av -> ax
hm AND ho -> hp
hi AND hk -> hl
gj AND gu -> gw
lh AND li -> lk
x RSHIFT 3 -> z
ib AND ic -> ie
jp AND ka -> kc
bo AND bu -> bw
lf AND lq -> ls
x RSHIFT 2 -> y
hq AND hs -> ht
ff AND fh -> fi
aw AND ay -> az
jq AND jw -> jy
il AND in -> io
gv AND gx -> gy
eg AND ei -> ej
dd AND do -> dq
b RSHIFT 2 -> d
br AND bt -> bu
ek AND em -> en
hz AND ik -> im
cq AND cs -> ct
as AND bd -> bf
bz AND cb -> cc
jr AND js -> ju
bv AND bx -> by
lj AND ll -> lm
fb AND fd -> fe
fw AND fy -> fz
kb AND kd -> ke
ec AND ee -> ef
fq AND fr -> ft
dz AND ef -> eh
hf AND hl -> hn
jp OR ka -> kb
z AND aa -> ac
1 AND jj -> jk
jq OR jw -> jx
y AND ae -> ag
ep OR eo -> eq
eu OR fa -> fb
hx OR hy -> hz
cj OR cp -> cq
ci OR ct -> cu
fo OR fz -> ga
x AND ai -> ak
lw OR lv -> lx
kg OR kf -> kh
iu OR jf -> jg
er OR es -> et
au OR av -> aw
de OR dk -> dl
gl OR gm -> gn
1 AND ds -> dt
1 AND fi -> fj
df OR dg -> dh
ib OR ic -> id
lf OR lq -> lr
bp OR bq -> br
hv OR hu -> hw
fk OR fj -> fl
he OR hp -> hq
dy OR ej -> ek
1 AND cx -> cy
1 AND bh -> bi
ck OR cl -> cm
dw OR dx -> dy
1 AND ke -> kf
iq OR ip -> ir
ea OR eb -> ec
iw OR ix -> iy
gk OR gq -> gr
fq OR fr -> fs
km OR kn -> ko
iv OR jb -> jc
bo OR bu -> bv
ev OR ew -> ex
hg OR hh -> hi
hc OR hd -> he
gj OR gu -> gv
bn OR by -> bz
kk OR kv -> kw
bl OR bm -> bn
as OR bd -> be
hz OR ik -> il
ce OR cd -> cf
1 AND io -> ip
hf OR hl -> hm
ha OR gz -> hb
ki OR kj -> kk
1 AND ht -> hu
ly OR lz -> ma
ld OR le -> lf
1 AND en -> eo
jr OR js -> jt
lh OR li -> lj
fm OR fn -> fo
gf OR ge -> gg
1 AND kz -> la
cg OR ch -> ci
lg OR lm -> ln
1 AND lu -> lv
db OR dc -> dd
kl OR kr -> ks
ao OR an -> ap
fp OR fv -> fw
jl OR jk -> jm
dz OR ef -> eg
1 AND gy -> gz
dd OR do -> dp
du OR dt -> dv
gh OR gi -> gj
lb OR la -> lc
bj OR bi -> bk
1 AND gd -> ge
ia OR ig -> ih
cz OR cy -> da
1 AND cc -> cd
1 AND am -> an
is OR it -> iu
jn OR jo -> jp
at OR az -> ba
aq OR ar -> as
et OR fe -> ff
x OR ai -> aj
y OR ae -> af
z OR aa -> ab
NOT dq -> dr
NOT kc -> kd
NOT cv -> cw
NOT cr -> cs
NOT ac -> ad
NOT ju -> jv
NOT ag -> ah
NOT iz -> ja
g AND i -> j
NOT gw -> gx
NOT jd -> je
NOT jy -> jz
NOT ca -> cb
NOT bf -> bg
NOT lk -> ll
NOT di -> dj
NOT gs -> gt
NOT kp -> kq
NOT dm -> dn
NOT ey -> ez
NOT go -> gp
d AND j -> l
NOT ft -> fu
NOT kx -> ky
NOT bs -> bt
NOT ii -> ij
o AND q -> r
NOT lo -> lp
NOT bw -> bx
NOT ax -> ay
NOT jh -> ji
NOT ed -> ee
NOT cn -> co
NOT gb -> gc
NOT el -> em
NOT fc -> fd
NOT im -> in
NOT hj -> hk
NOT ie -> if
NOT ak -> al
NOT kt -> ku
k AND m -> n
NOT bb -> bc
NOT eh -> ei
NOT fx -> fy
NOT ls -> lt
1 AND r -> s
NOT fg -> fh
e AND f -> h
NOT hn -> ho
NOT hr -> hs
b AND n -> p
e OR f -> g
v OR w -> x
d OR j -> k
t OR s -> u
b OR n -> o
NOT h -> i
NOT p -> q
NOT l -> m
1674 -> b
lx -> a
0 -> c
